W W W W W W W W W W W W W W W
W _ _ _ _ _ _ _ _ _ _ _ R _ W
W _ _ _ _ _ _ _ _ _ _ _ _ _ W
W _ _ _ R _ _ _ _ _ _ _ _ _ W
W _ _ _ _ _ W _ _ _ R _ _ _ W
W _ _ _ _ _ W _ _ _ _ _ _ _ W
W _ _ _ _ _ W _ _ _ _ _ _ _ W
W _ _ _ _ _ _ _ R _ _ _ _ _ W
W _ _ _ _ _ W _ _ _ _ _ _ _ W
W _ _ _ R _ _ _ _ _ _ _ _ _ W
W _ _ _ _ _ _ _ _ _ _ _ _ _ W
W _ _ _ _ _ _ _ _ _ _ S _ _ W
W _ _ _ _ _ _ _ _ _ _ _ _ _ W
W _ _ _ _ _ _ _ _ _ _ _ _ _ W
W W W W W W W W W W W W W W W